...................................................................................................
...................................................................................................
...................................................................................................
...................................................................................................
...................................................................................................
...................................................................................................
...................................................................................................
...................................................................................................
...................................................................................................
...................................................................................................
...................................................................................................
...................................................................................................
...................................................................................................
...................................................................................................
...................................................................................................
...................................................................................................
...................................................................................................
...................................................................................................
...................................................................................................
...................................................................................................
.................----------------------............................................................
................--....................---..........................................................
...............--.......................--.........................................................
..............--.........................--...............----..........----.......................
.............--...........................--.............--..--........--..--......................
............--.............................--...........--....--......--....--......----...........
.............--.............................--.........--......--....--......--....--..--..........
..............--.............................--.......--........--..--........--..--....--.........
...............--.............................---------..........----..........----......--........
................--............X.........................................................--.........
..................--..................................................................--...........
...................--...............................................................--.............
..................................................--..............................--...............
..................................................---------------------------------................
.............................................................................--....................
...........................................................................--......................
.........................................................................--........................
........................................................................--.........................
.........................................................................--........................
..........................................................................--.......................
............................................................................--.....................
.........................................------------------------------------......................
...................-----------------------.........................................................
...................--..............................................................................
...................--..............................................................................
...................--..............................................................................
...................--..............................................................................
...................--..............................................................................
...................--..............................................................................
...................--..............................................................................
...................--..............................................................................
...................--..............................................................................
...................--..............................................................................
...................----------------------------------------------------------......................
............................................................................--------...............
..................................................................................--...............
..................................................................................--...............
..................................................----------------................--...............
.................................................--..............--...............--...............
................................................--......-----...--.................--..............
...............................................--.........--..--....................--.............
.................................................--.........--.......................--............
..................................................----................................--...........
..................................................--------------.......................--..........
......................................--------------...........---------------------------.........
......................................---..........................................................
......................................--...........................................................
.....................................--............................................................
...................................--..............................................................
.................................---..................................O............................
.................................--................................................................
................................--.................................................................
.................................--................................................................
.................................--................................................................
..................................--...............................................................
...................................------------------------........................................
...................................................................................................
...................................................................................................
...................................................................................................
...................................................................................................
...................................................................................................
...................................................................................................
...................................................................................................
...................................................................................................
...................................................................................................
...................................................................................................
...................................................................................................
...................................................................................................
...................................................................................................
...................................................................................................
...................................................................................................
...................................................................................................
...................................................................................................
...................................................................................................
...................................................................................................
...................................................................................................
...................................................................................................
...................................................................................................
...................................................................................................
...................................................................................................
